MMMMMMMMMMMMMMMMMMMMMMMMMMMMMMMMMMMMMMMMMMMMMMMMMMMMMMMMMMMMMMMMMMMMMMMMMMMMMMMMMMMMMMMMMMMMMMMMMMMMMMMMMMMMMMMMMMMMMMMMMMMMMMMMMMMMMMMMMMMMMMMMMMMMMMMMMMMMMMMMMMMMMMMMMMMMMMMMMMMMMMMMMMMMMMMMMMMMMMMMMMMMMMMMMMMMMMMMMMMMMMMMMMMMMMMMMMMMMMMMMMMMMMMMMMMMMMMMMMMMMMMMMMMMMMMMMMMMMMMMMMMMMMMMMMMMMMMMMMMMMMMMMMMMMMMMMMMMMMMMMMMMMMMMMMMMMMMMMMMMMMMMMMMMMMMMMMMMMMMMMMMMMMMMMMMMMMMMMMMMMMMMMMMMMMMMMMM
MM                                                                                                                                                                                                                                                                 MMMMMMMMMMMMMMMMMMMMMMMMMMM                                                                                                          MMM     
MM                                                                                                                                                                                                                                                                 MMMMMMMMMMMMMMMMMMMMMMMMMMM                                                                                                          MMM     
MM                                                                                                                                                                                                                                                                 MMMMMMMMMMMMMMMMMMMMMMMMMMM                                                                                                          MMM     
MM                                                                                                                                                                                                                                                                 MMMMMMMMMMMMMMMMMMMMMMMMMMM                                                                                                          MMM     
MM                                                                                                                                                                                                                                                                 MMMMMMMMMMMMMMMMMMMMMMMMMMM                                                                                                          MMM     
MM                                                                                                                                                                                                                                                                 MMMMMMMMMMMMMMMMMMMMMMMMMMM                                                                                                          MMM     
MM                                                                                                                                                                                                                                                                 MMMMMMMMMMMMMMMM                                                                                           MMMMMMMMMM                MMM     
MM                                                                                                                                                                                                                                                                 MMMMMMMMMMMMMMMM                                                                                           MMMMMMMMMM                MMM     
MM                                                                                                                                                                                                                                                                 MMMMMMMMMMMMMMMM                                                                                           MMMMMMMMMM                MMM     
MM                                                                                                                                                                                                                                                                 MMMMMMMMMMMMMMMM                                                                                                                |||  MMM     
MM                                                                                                                                                                                                                                                                 MMMMMMMMMMMMMMMM                                 MMMMMMMMMMM                                                                    |||  MMM     
MM                                                                                                                                                                                                                                                                 MMMMMMMMMMMMMMMM                                 MMMMMMMMMMM                                                                    |||  MMM     
MM                                                                                                                                                                                                                                                                                                                  MMMMMMMMMMM                                                                    |||  MMM     
MM                                                                                                                                                                                                                                                                                         MMMMMMM                                                                                                 |||  MMM     
MM                                                                                                                                                                                                                                                                                        MMMMMMMM                                      MMMMMMMMMMMMMMMMMMMMMMMMMMM                                |||  MMM     
MM                                                                                                                                                                                                                                                                                       MMMMMMMMM                                      MMMMMMMMMMMMMMMMMMMMMMMMMMM                                |||  MMM     
MM                                                                                                                                                                                                                                                                                      MMMMMMMMMM                                      MMMMMMMMMMMMMMMMMMMMMMMMMMM                              MMMMMMMMMM     
MM                                                                                                                                                                                                                                                     MMMMMMMMMMMMMMMMMMMMMMMMMMMMMMMMMMMMMMM                                          MMMMMMMMMMMMMMMMMMMMMMMMMMM..............................MMMMMMMMMM     
MM                                                                                                                                                                                                                                                     MMMMMMMMMMMMMMMMMMMMMMMMMMMMMMMMMMMMMMM                     MMMMMMMMMMMM         MMMMMMMMMMMMMMMMMMMMMMMMMMM..............................MMMMMMMMMM     
MM                                                                                                                                                                                                                                                     MMMMMMMMMMMMMMMMMMMMMMMMMMMMMMMMMMMMMMM                     MMMMMMMMMMMM         MMMMMMMMMMMMMMMMMMMMMMMMMMM..............................MMMMMMMMMM     
MM                                                                                                                                                                                                                                                     MMMMMMMMMMMMMMMMMMMMMMMMMMMMMMMMMMMMMMM                     MMMMMMMMMMMM         MMMMMMMMMMMMMMMMMMMMMMMMMMM..............................MMMMMMMMMM     
MM                                                                            MMMMMMMMMM                                                                                                                           MMMMMMMMMMMMMM                                  MMMMMMMMMMMMMMMMMMMMMMMMMMM                     MMMMMMMMMMMM         MMMMMMMMMMMMMMMMMMMMMMMMMMMMMMMMMMMMMMMMMMMMMMMMMMMMMMMMMMMMMMMMMMM     
MM                                                                            MMMMMMMMMM                                                                                                                           MMMMMMMMMMMMMM                                  MMMMMMMMMMMMMMMMMMMMMMMMMMM                     MMMMMMMMMMMM         MMMMMMMMMMMMMMMMMMMMMMMMMMMMMMMMMMMMMMMMMMMMMMMMMMMMMMMMMMMMMMMMMMM     
MM                                                                            MMMMMMMMMM                                                                                                                           MMMMMMMMMMMMMM                                  MMMMMMMMMMMMMMMMMMMMMMMMMMM                     MMMMMMMMMMMM.........MMMMMMMMMMMMMMMMMMMMMMMMMMMMMMMMMMMMMMMMMMMMMMMMMMMMMMMMMMMMMMMMMMM     
MM                                                                            MMMMMMMMMM                                                                                                                           MMMMMMMMMMMMMM                                  MMMMMMMMMMMMMMMMMMMMMMMMMMM                     MMMMMMMMMMMM.........MMMMMMMMMMMMMMMMMMMMMMMMMMMMMMMMMMMMMMMMMMMMMMMMMMMMMMMMMMMMMMMMMMM     
MM                                                                            MMMMMMMMMM                                                                                                                                                                                                                           MMMMMMMMMMMM.........MMMMMMMMMMMMMMMMMMMMMMMMMMMMMMMMMMMMMMMMMMMMMMMMMMMMMMMMMMMMMMMMMMM     
MM                                                                                                                                                                                                                                                                                                       MMMMMMMMMMMMMMMMMMMMMMMMMMMMMMMMMMMMMMMMMMMMMMMMMMMMMMMMMMMMMMMMMMMMMMMMMMMMMMMMMMMMMMMMMMMMMMMMMM     
MM                                                                                                                                                                                                                                                                                                       MMMMMMMMMMMMMMMMMMMMMMMMMMMMMMMMMMMMMMMMMMMMMMMMMMMMMMMMMMMMMMMMMMMMMMMMMMMMMMMMMMMMMMMMMMMMMMMMMM     
MM                                                                                                                                                                           MMMMMMMMMMMMMMMMM                                                                                                           MMMMMMMMMMMMMMMMMMMMMMMMMMMMMMMMMMMMMMMMMMMMMMMMMMMMMMMMMMMMMMMMMMMMMMMMMMMMMMMMMMMMMMMMMMMMMMMMMM     
MM                                                                                                 MMMMMMMMMMMM                                                              MMMMMMMMMMMMMMMMM                                                                                                           MMMMMMMMMMMMMMMMMMMMMMMMMMMMMMMMMMMMMMMMMMMMMMMMMMMMMMMMMMMMMMMMMMMMMMMMMMMMMMMMMMMMMMMMMMMMMMMMMM     
MM                                             MMMMMMMMMMMMM                                       MMMMMMMMMMMM                                                              MMMMMMMMMMMMMMMMM                                                                                                           MMMMMMMMMMMMMMMMMMMMMMMMMMMMMMMMMMMMMMMMMMMMMMMMMMMMMMMMMMMMMMMMMMMMMMMMMMMMMMMMMMMMMMMMMMMMMMMMMM     
MM                                             MMMMMMMMMMMMM                                       MMMMMMMMMMMM                                                              MMMMMMMMMMMMMMMMM                                                                                                           MMMMMMMMMMMMMMMMMMMMMMMMMMMMMMMMMMMMMMMMMMMMMMMMMMMMMMMMMMMMMMMMMMMMMMMMMMMMMMMMMMMMMMMMMMMMMMMMMM     
MM                                             MMMMMMMMMMMMM                                       MMMMMMMMMMMM                   MMMMMMMMMMMMMMM                 MMMMMMMMMMMMMMMMMMMMMMMMMMMM                                                                                                           MMMMMMMMMMMMMMMMMMMMMMMMMMMMMMMMMMMMMMMMMMMMMMMMMMMMMMMMMMMMMMMMMMMMMMMMMMMMMMMMMMMMMMMMMMMMMMMMMM     
MM                                             MMMMMMMMMMMMM                                                                      MMMMMMMMMMMMMMM                 MMMMMMMMMMMMMMMMMMMMMMMMMMMM                                                                                                           MMMMMMMMMMMMMMMMMMMMMMMMMMMMMMMMMMMMMMMMMMMMMMMMMMMMMMMMMMMMMMMMMMMMMMMMMMMMMMMMMMMMMMMMMMMMMMMMMM     
MM                                                                                                                                MMMMMMMMMMMMMMM                 MMMMMMMMMMMMMMMMMMMMMMMMMMMM                                                                                                           MMMMMMMMMMMMMMMMMMMMMMMMMMMMMMMMMMMMMMMMMMMMMMMMMMMMMMMMMMMMMMMMMMMMMMMMMMMMMMMMMMMMMMMMMMMMMMMMMM     
MMMMMMMMMMMMMMMMMMMMMMMMMMMMMMMMMMMMMMMMMMMM                                                                                      MMMMMMMMMMMMMMM                 MMMMMMMMMMMMMMMMMMMMMMMMMMMM                                                                          MMMMMMMMMMMMMMMMMMMMMMMMMMMMMMMMMMMMMMMMMMMMMMMMMMMMMMMMMMMMMMMMMMMMMMMMMMMMMMMMMMMMMMMMMMMMMMMMMMMMMMMMMMMMMMMMMMMMMMMMMMMMMMMMMMM     
MMMMMMMMMMMMMMMMMMMMMMMMMMMMMMMMMMMMMMMMMMMM......................................................................................................................MMMMMMMMMMMMMMMMMMMMMMMMMMMM                                                                          MMMMMMMMMMMMMMMMMMMMMMMMMMMMMMMMMMMMMMMMMMMMMMMMMMMMMMMMMMMMMMMMMMMMMMMMMMMMMMMMMMMMMMMMMMMMMMMMMMMMMMMMMMMMMMMMMMMMMMMMMMMMMMMMMMM     
MMMMMMMMMMMMMMMMMMMMMMMMMMMMMMMMMMMMMMMMMMMM......................................................................................................................MMMMMMMMMMMMMMMMMMMMMMMMMMMMMMMMMMMMMMMMMMMMMMMMMMMMMMMMMMMMMMMMMMMMMMM                               MMMMMMMMMMMMMMMMMMMMMMMMMMMMMMMMMMMMMMMMMMMMMMMMMMMMMMMMMMMMMMMMMMMMMMMMMMMMMMMMMMMMMMMMMMMMMMMMMMMMMMMMMMMMMMMMMMMMMMMMMMMMMMMMMMM     
MMMMMMMMMMMMMMMMMMMMMMMMMMMMMMMMMMMMMMMMMMMM......................................................................................................................MMMMMMMMMMMMMMMMMMMMMMMMMMMMMMMMMMMMMMMMMMMMMMMMMMMMMMMMMMMMMMMMMMMMMMM...............................MMMMMMMMMMMMMMMMMMMMMMMMMMMMMMMMMMMMMMMMMMMMMMMMMMMMMMMMMMMMMMMMMMMMMMMMMMMMMMMMMMMMMMMMMMMMMMMMMMMMMMMMMMMMMMMMMMMMMMMMMMMMMMMMMMM     
MMMMMMMMMMMMMMMMMMMMMMMMMMMMMMMMMMMMMMMMMMMM......................................................................................................................MMMMMMMMMMMMMMMMMMMMMMMMMMMMMMMMMMMMMMMMMMMMMMMMMMMMMMMMMMMMMMMMMMMMMMM...............................MMMMMMMMMMMMMMMMMMMMMMMMMMMMMMMMMMMMMMMMMMMMMMMMMMMMMMMMMMMMMMMMMMMMMMMMMMMMMMMMMMMMMMMMMMMMMMMMMMMMMMMMMMMMMMMMMMMMMMMMMMMMMMMMMMM     
MMMMMMMMMMMMMMMMMMMMMMMMMMMMMMMMMMMMMMMMMMMM......................................................................................................................MMMMMMMMMMMMMMMMMMMMMMMMMMMMMMMMMMMMMMMMMMMMMMMMMMMMMMMMMMMMMMMMMMMMMMM...............................MMMMMMMMMMMMMMMMMMMMMMMMMMMMMMMMMMMMMMMMMMMMMMMMMMMMMMMMMMMMMMMMMMMMMMMMMMMMMMMMMMMMMMMMMMMMMMMMMMMMMMMMMMMMMMMMMMMMMMMMMMMMMMMMMMM     
MMMMMMMMMMMMMMMMMMMMMMMMMMMMMMMMMMMMMMMMMMMMMMMMMMMMMMMMMMMMMMMMMMMMMMMMMMMMMMMMMMMMMMMMMMMMMMMMMMMMMMMMMMMMMMMMMMMMMMMMMMMMMMMMMMMMMMMMMMMMMMMMMMMMMMMMMMMMMMMMMMMMMMMMMMMMMMMMMMMMMMMMMMMMMMMMMMMMMMMMMMMMMMMMMMMMMMMMMMMMMMMMMMMMMMMMMMMMMMMMMMMMMMMMMMMMMMMMMMMMMMMMMMMMMMMMMMMMMMMMMMMMMMMMMMMMMMMMMMMMMMMMMMMMMMMMMMMMMMMMMMMMMMMMMMMMMMMMMMMMMMMMMMMMMMMMMMMMMMMMMMMMMMMMMMMMMMMMMMMMMMMMMMMMMMMMMMM     
MMMMMMMMMMMMMMMMMMMMMMMMMMMMMMMMMMMMMMMMMMMMMMMMMMMMMMMMMMMMMMMMMMMMMMMMMMMMMMMMMMMMMMMMMMMMMMMMMMMMMMMMMMMMMMMMMMMMMMMMMMMMMMMMMMMMMMMMMMMMMMMMMMMMMMMMMMMMMMMMMMMMMMMMMMMMMMMMMMMMMMMMMMMMMMMMMMMMMMMMMMMMMMMMMMMMMMMMMMMMMMMMMMMMMMMMMMMMMMMMMMMMMMMMMMMMMMMMMMMMMMMMMMMMMMMMMMMMMMMMMMMMMMMMMMMMMMMMMMMMMMMMMMMMMMMMMMMMMMMMMMMMMMMMMMMMMMMMMMMMMMMMMMMMMMMMMMMMMMMMMMMMMMMMMMMMMMMMMMMMMMMMMMMMMMMMMMM